------------------
|                |
|    Welcome     |
|                |
|                |
--------- --------