------------------
|                |
|             |  |
|         -------|
|                |
------*-----------