-------------------------------------------------;;;;;;;;;;;;;;;;;;;
|                                               |;;;;;;;;;;;;;;;;;;;
|  --    --  -----------------                   -------------------
|            -----------------                                     |
|     --     -------------   -                                     |
|            ------------   --                                     |
|----------------------    ---||||||||||||||||||||||||||||||||||||||
|---      ------------    ----    -----        --------            |
|----*      --------    ------    -----        --------            |
|-------     ------   --------    -----        --------            |
|------------      -----------    |||||        |||||||| -----------|
|--------------------*---------------------------------------------|
|                                                                  |
|----------------------    ----    |   --           --             |
              |        --          |  |  |  | | |  |  |            |
              |      |     --------    --|   - -    --|            |
              ------ -----|              |--          |--          |
              |           |                                        |
              ----------- |----------------------------------------|
                               |                                   |
              ---------------------------------------------------  -