------------------
|             |  |
|             |  |
|         -------|
|                |
------*----- -----