---------------------------------------------------------------------------------------------------
|                                     |                                 - -----                   |
|    - -                         --*--------------      ---    --     --- ---              #      |
|     -                               |   |          --    ---- |   ----- -             -         |
|                                     |                         |                                 |
------------------------------------------------- ------- ----------------------- -----------------